**********
*       O*
* * ******
* *      *
* ** * ***
* *  * * *
* *      *
* *** ****
* *     P*
**********
