********************
*P                 *
*                  *
*                  *
*                  *
*                  *
*                  *
*                  *
*                  *
*        O         *
*                  *
*                  *
*                  *
*                  *
*                  *
*                  *
*                  *
*                  *
*                  *
********************
