**********
*        *
*        *
*        *
*    P   *
*        *
*        *
*        *
*       O*
**********
